Frequency (Hz),Insertion Gain (dB),Noise Figure (dB)
+00010E+06,+08015E-03,+31420E-03
+00020E+06,+90000E+06,+90099E+06
+00030E+06,+24644E-03,+18535E-03
+00040E+06,+38401E-03,+04376E-03
+00050E+06,+38735E-03,+04028E-03
+00060E+06,+38941E-03,+04087E-03
+00070E+06,+38867E-03,+04151E-03
+00080E+06,+38659E-03,+04223E-03
+00090E+06,+38485E-03,+04177E-03
+00100E+06,+38525E-03,+04025E-03
+00110E+06,+38721E-03,+03954E-03
+00120E+06,+38929E-03,+03809E-03
+00130E+06,+38940E-03,+03865E-03
+00140E+06,+38866E-03,+03777E-03
+00150E+06,+38638E-03,+03841E-03
+00160E+06,+38413E-03,+03935E-03
+00170E+06,+38373E-03,+03962E-03
+00180E+06,+38431E-03,+04094E-03
+00190E+06,+38613E-03,+04233E-03
+00200E+06,+38682E-03,+04287E-03
+00210E+06,+38457E-03,+04397E-03
+00220E+06,+38285E-03,+04405E-03
+00230E+06,+38163E-03,+04508E-03
+00240E+06,+38277E-03,+04454E-03
+00250E+06,+38387E-03,+04527E-03
+00260E+06,+38443E-03,+04550E-03
+00270E+06,+38331E-03,+04524E-03
+00280E+06,+38183E-03,+04510E-03
+00290E+06,+38134E-03,+04555E-03
+00300E+06,+38135E-03,+04595E-03
+00310E+06,+38265E-03,+04603E-03
+00320E+06,+38336E-03,+04734E-03
+00330E+06,+38193E-03,+04875E-03
+00340E+06,+37918E-03,+05045E-03
+00350E+06,+37647E-03,+05090E-03
+00360E+06,+37594E-03,+05204E-03
+00370E+06,+37683E-03,+05354E-03
+00380E+06,+37760E-03,+05465E-03
+00390E+06,+37607E-03,+05601E-03
+00400E+06,+37233E-03,+05497E-03
+00410E+06,+36940E-03,+05421E-03
+00420E+06,+36820E-03,+05395E-03
+00430E+06,+36669E-03,+05444E-03
+00440E+06,+36376E-03,+05599E-03
+00450E+06,+36219E-03,+05917E-03
+00460E+06,+36047E-03,+06468E-03
+00470E+06,+35426E-03,+07346E-03
+00480E+06,+34352E-03,+08511E-03
+00490E+06,+33176E-03,+09578E-03
+00500E+06,+31820E-03,+11115E-03
+00510E+06,+29751E-03,+12701E-03
+00520E+06,+26343E-03,+15168E-03
+00530E+06,+22675E-03,+18289E-03
+00540E+06,+17886E-03,+22923E-03
+00550E+06,+12931E-03,+27844E-03
+00560E+06,+90000E+06,+90099E+06
+00570E+06,+90000E+06,+90099E+06
+00580E+06,+90000E+06,+90099E+06
+00590E+06,+90000E+06,+90099E+06
+00600E+06,+90000E+06,+90099E+06
+00610E+06,+90000E+06,+90099E+06
+00620E+06,+90000E+06,+90099E+06
+00630E+06,+90000E+06,+90099E+06
+00640E+06,+90000E+06,+90099E+06
+00650E+06,+90000E+06,+90099E+06
+00660E+06,+90000E+06,+90099E+06
+00670E+06,+90000E+06,+90099E+06
+00680E+06,+90000E+06,+90099E+06
+00690E+06,+90000E+06,+90099E+06
+00700E+06,+90000E+06,+90099E+06
+00710E+06,+90000E+06,+90099E+06
+00720E+06,+90000E+06,+90099E+06
+00730E+06,+90000E+06,+90099E+06
+00740E+06,+90000E+06,+90099E+06
+00750E+06,+90000E+06,+90099E+06
+00760E+06,+90000E+06,+90099E+06
+00770E+06,+90000E+06,+90099E+06
+00780E+06,+06735E-03,+31982E-03
+00790E+06,+90000E+06,+90099E+06
+00800E+06,+90000E+06,+90099E+06
+00810E+06,+90000E+06,+90099E+06
+00820E+06,+90000E+06,+90099E+06
+00830E+06,+90000E+06,+90099E+06
+00840E+06,+90000E+06,+90099E+06
+00850E+06,+90000E+06,+90099E+06
+00860E+06,+90000E+06,+90099E+06
+00870E+06,+90000E+06,+90099E+06
+00880E+06,+90000E+06,+90099E+06
+00890E+06,+90000E+06,+90099E+06
+00900E+06,+90000E+06,+90099E+06
+00910E+06,+90000E+06,+90099E+06
+00920E+06,+90000E+06,+90099E+06
+00930E+06,+90000E+06,+90099E+06
+00940E+06,+90000E+06,+90099E+06
+00950E+06,+90000E+06,+90099E+06
+00960E+06,+90000E+06,+90099E+06
+00970E+06,+90000E+06,+90099E+06
+00980E+06,+90000E+06,+90099E+06
+00990E+06,+90000E+06,+90099E+06
+01000E+06,+90000E+06,+90099E+06
+01010E+06,+90000E+06,+90099E+06
+01020E+06,+90000E+06,+90099E+06
+01030E+06,+90000E+06,+90099E+06
+01040E+06,+90000E+06,+90099E+06
+01050E+06,+90000E+06,+90099E+06
+01060E+06,+90000E+06,+90099E+06
+01070E+06,+90000E+06,+90099E+06
+01080E+06,+90000E+06,+90099E+06
+01090E+06,+90000E+06,+90099E+06
+01100E+06,+90000E+06,+90099E+06
+01110E+06,+90000E+06,+90099E+06
+01120E+06,+90000E+06,+90099E+06
+01130E+06,+90000E+06,+90099E+06
+01140E+06,+90000E+06,+90099E+06
+01150E+06,+90000E+06,+90099E+06
+01160E+06,+90000E+06,+90099E+06
+01170E+06,+90000E+06,+90099E+06
+01180E+06,+90000E+06,+90099E+06
+01190E+06,+90000E+06,+90099E+06
+01200E+06,+90000E+06,+90099E+06
+01210E+06,+90000E+06,+90099E+06
+01220E+06,+90000E+06,+90099E+06
+01230E+06,+90000E+06,+90099E+06
+01240E+06,+90000E+06,+90099E+06
+01250E+06,+90000E+06,+90099E+06
+01260E+06,+90000E+06,+90099E+06
+01270E+06,+90000E+06,+90099E+06
+01280E+06,+90000E+06,+90099E+06
+01290E+06,+90000E+06,+90099E+06
+01300E+06,+90000E+06,+90099E+06
+01310E+06,+90000E+06,+90099E+06
+01320E+06,+90000E+06,+90099E+06
+01330E+06,+90000E+06,+90099E+06
+01340E+06,+90000E+06,+90099E+06
+01350E+06,+90000E+06,+90099E+06
+01360E+06,+90000E+06,+90099E+06
+01370E+06,+90000E+06,+90099E+06
+01380E+06,+90000E+06,+90099E+06
+01390E+06,+90000E+06,+90099E+06
+01400E+06,+90000E+06,+90099E+06
+01410E+06,+90000E+06,+90099E+06
+01420E+06,+90000E+06,+90099E+06
+01430E+06,+90000E+06,+90099E+06
+01440E+06,+90000E+06,+90099E+06
+01450E+06,+90000E+06,+90099E+06
+01460E+06,+90000E+06,+90099E+06
+01470E+06,+90000E+06,+90099E+06
+01480E+06,+90000E+06,+90099E+06
+01490E+06,+90000E+06,+90099E+06
+01500E+06,+90000E+06,+90099E+06
+01510E+06,+90000E+06,+90099E+06
+01520E+06,+90000E+06,+90099E+06
+01530E+06,+90000E+06,+90099E+06
+01540E+06,+90000E+06,+90099E+06
+01550E+06,+90000E+06,+90099E+06
+01560E+06,+90000E+06,+90099E+06
+01570E+06,+90000E+06,+90099E+06
+01580E+06,+90000E+06,+90099E+06
+01590E+06,+90000E+06,+90099E+06
