Frequency (Hz),Insertion Gain (dB),Noise Figure (dB)
+00010E+06,+10091E-03,+29566E-03
+00030E+06,+24638E-03,+18935E-03
+00050E+06,+38526E-03,+04460E-03
+00070E+06,+38559E-03,+04484E-03
+00090E+06,+38067E-03,+04785E-03
+00110E+06,+38349E-03,+04468E-03
+00130E+06,+38616E-03,+04198E-03
+00150E+06,+38336E-03,+04109E-03
+00170E+06,+37875E-03,+04398E-03
+00190E+06,+38157E-03,+04660E-03
+00210E+06,+38221E-03,+04874E-03
+00230E+06,+37896E-03,+04904E-03
+00250E+06,+38124E-03,+04854E-03
+00270E+06,+38127E-03,+04822E-03
+00290E+06,+37809E-03,+04931E-03
+00310E+06,+37822E-03,+05092E-03
+00330E+06,+37888E-03,+05399E-03
+00350E+06,+37246E-03,+05634E-03
+00370E+06,+37371E-03,+05767E-03
+00390E+06,+37320E-03,+05749E-03
+00410E+06,+36742E-03,+05699E-03
+00430E+06,+36274E-03,+05805E-03
+00450E+06,+35845E-03,+06346E-03
+00470E+06,+35337E-03,+07734E-03
+00490E+06,+32944E-03,+09998E-03
+00510E+06,+29337E-03,+13222E-03
+00530E+06,+21896E-03,+19331E-03
+00550E+06,+12795E-03,+28316E-03
+00570E+06,+90000E+06,+90099E+06
+00590E+06,+90000E+06,+90099E+06
+00610E+06,+90000E+06,+90099E+06
+00630E+06,+90000E+06,+90099E+06
+00650E+06,+90000E+06,+90099E+06
+00670E+06,+90000E+06,+90099E+06
+00690E+06,+90000E+06,+90099E+06
+00710E+06,+90000E+06,+90099E+06
+00730E+06,+90000E+06,+90099E+06
+00750E+06,+90000E+06,+90099E+06
+00770E+06,+90000E+06,+90099E+06
+00790E+06,+90000E+06,+90099E+06
+00810E+06,+90000E+06,+90099E+06
+00830E+06,+90000E+06,+90099E+06
+00850E+06,+90000E+06,+90099E+06
+00870E+06,+90000E+06,+90099E+06
+00890E+06,+90000E+06,+90099E+06
+00910E+06,+90000E+06,+90099E+06
+00930E+06,+90000E+06,+90099E+06
+00950E+06,+90000E+06,+90099E+06
+00970E+06,+90000E+06,+90099E+06
+00990E+06,+90000E+06,+90099E+06
+01010E+06,+90000E+06,+90099E+06
+01030E+06,+90000E+06,+90099E+06
+01050E+06,+90000E+06,+90099E+06
+01070E+06,+90000E+06,+90099E+06
+01090E+06,+90000E+06,+90099E+06
+01110E+06,+90000E+06,+90099E+06
+01130E+06,+90000E+06,+90099E+06
+01150E+06,+90000E+06,+90099E+06
+01170E+06,+90000E+06,+90099E+06
+01190E+06,+90000E+06,+90099E+06
+01210E+06,+90000E+06,+90099E+06
+01230E+06,+90000E+06,+90099E+06
+01250E+06,+90000E+06,+90099E+06
+01270E+06,+90000E+06,+90099E+06
+01290E+06,+90000E+06,+90099E+06
+01310E+06,+90000E+06,+90099E+06
+01330E+06,+90000E+06,+90099E+06
+01350E+06,+90000E+06,+90099E+06
+01370E+06,+90000E+06,+90099E+06
+01390E+06,+90000E+06,+90099E+06
+01410E+06,+90000E+06,+90099E+06
+01430E+06,+90000E+06,+90099E+06
+01450E+06,+90000E+06,+90099E+06
+01470E+06,+90000E+06,+90099E+06
+01490E+06,+90000E+06,+90099E+06
+01510E+06,+90000E+06,+90099E+06
+01530E+06,+90000E+06,+90099E+06
+01550E+06,+90000E+06,+90099E+06
+01570E+06,+90000E+06,+90099E+06
+01590E+06,+90000E+06,+90099E+06
