Frequency (Hz),Insertion Gain (dB),Noise Figure (dB)
+00010E+06,+10367E-03,+29247E-03
+00030E+06,+25583E-03,+18507E-03
+00050E+06,+39357E-03,+04338E-03
+00070E+06,+39440E-03,+04345E-03
+00090E+06,+39134E-03,+04637E-03
+00110E+06,+39338E-03,+04355E-03
+00130E+06,+39381E-03,+04129E-03
+00150E+06,+39167E-03,+04025E-03
+00170E+06,+38820E-03,+04316E-03
+00190E+06,+39044E-03,+04505E-03
+00210E+06,+39070E-03,+04705E-03
+00230E+06,+38738E-03,+04709E-03
+00250E+06,+38893E-03,+04722E-03
+00270E+06,+38946E-03,+04575E-03
+00290E+06,+38680E-03,+04742E-03
+00310E+06,+38658E-03,+04914E-03
+00330E+06,+38721E-03,+05275E-03
+00350E+06,+38157E-03,+05431E-03
+00370E+06,+38161E-03,+05587E-03
+00390E+06,+38074E-03,+05653E-03
+00410E+06,+37563E-03,+05535E-03
+00430E+06,+37286E-03,+05577E-03
+00450E+06,+36839E-03,+06176E-03
+00470E+06,+36317E-03,+07440E-03
+00490E+06,+34248E-03,+09485E-03
+00510E+06,+31018E-03,+12400E-03
+00530E+06,+24289E-03,+17686E-03
+00550E+06,+15140E-03,+26888E-03
+00570E+06,+90000E+06,+90099E+06
+00590E+06,+90000E+06,+90099E+06
+00610E+06,+90000E+06,+90099E+06
+00630E+06,+90000E+06,+90099E+06
+00650E+06,+90000E+06,+90099E+06
+00670E+06,+90000E+06,+90099E+06
+00690E+06,+90000E+06,+90099E+06
+00710E+06,+90000E+06,+90099E+06
+00730E+06,+90000E+06,+90099E+06
+00750E+06,+90000E+06,+90099E+06
+00770E+06,+90000E+06,+90099E+06
+00790E+06,+90000E+06,+90099E+06
+00810E+06,+90000E+06,+90099E+06
+00830E+06,+90000E+06,+90099E+06
+00850E+06,+90000E+06,+90099E+06
+00870E+06,+90000E+06,+90099E+06
+00890E+06,+90000E+06,+90099E+06
+00910E+06,+90000E+06,+90099E+06
+00930E+06,+90000E+06,+90099E+06
+00950E+06,+90000E+06,+90099E+06
+00970E+06,+90000E+06,+90099E+06
+00990E+06,+90000E+06,+90099E+06
+01010E+06,+90000E+06,+90099E+06
+01030E+06,+90000E+06,+90099E+06
+01050E+06,+90000E+06,+90099E+06
+01070E+06,+90000E+06,+90099E+06
+01090E+06,+90000E+06,+90099E+06
+01110E+06,+90000E+06,+90099E+06
+01130E+06,+90000E+06,+90099E+06
+01150E+06,+90000E+06,+90099E+06
+01170E+06,+90000E+06,+90099E+06
+01190E+06,+90000E+06,+90099E+06
+01210E+06,+90000E+06,+90099E+06
+01230E+06,+90000E+06,+90099E+06
+01250E+06,+90000E+06,+90099E+06
+01270E+06,+90000E+06,+90099E+06
+01290E+06,+90000E+06,+90099E+06
+01310E+06,+90000E+06,+90099E+06
+01330E+06,+90000E+06,+90099E+06
+01350E+06,+90000E+06,+90099E+06
+01370E+06,+90000E+06,+90099E+06
+01390E+06,+90000E+06,+90099E+06
+01410E+06,+90000E+06,+90099E+06
+01430E+06,+90000E+06,+90099E+06
+01450E+06,+90000E+06,+90099E+06
+01470E+06,+90000E+06,+90099E+06
+01490E+06,+90000E+06,+90099E+06
+01510E+06,+90000E+06,+90099E+06
+01530E+06,+90000E+06,+90099E+06
+01550E+06,+90000E+06,+90099E+06
+01570E+06,+90000E+06,+90099E+06
+01590E+06,+90000E+06,+90099E+06
